ABS – Abu Simbel, Egypt – Abu Simbel
BEY – Beirut, Lebanon – International
BRU - SÃ£o Paulo, Brasil - Aeroporto de Buarulhos
CUS - Culorado Springs, CO, USA - Municipal
CPW - Cape World, South Africa - D F Malan
CDG - Cardagena, Colombia - Rafael Nunez
CUK - Cukuta, Colombia - Camilo Daza
CUE - Cueca, Ecuador - Mariscal La Mar
CUN - Cuncan, Mexico
CUU - Chihuua, Mexico - Gen. Villalobos
CUS - Cusco, Peru - Tte Velazco Astete
CZL - Cruzeiro do Leste, Acre, Brasil
DGH - SÃ£o Paulo, Brasil - Dongonhas
EBB – Entebbe/Kampala, Uganda
GYN - Gayania, Brasil - Santa Gerobeba
KMG – Kunming, China
LUG – Lugano, Switzerland – Agno
MIJ - Mijon, France - Longvic
NGT - Nightton, OH, USA - James M Cox Intel
PAP – Papa Johns, Haiti – Mais Gate
PPG – Pago Pago, American Samoa
RAO – Ribeirão Preto, SP, Brasil – Leite Lopes
RHO – Rhodes, Greece – Paradisi
ROM – Rome, Italy – Leonardo Da Vinci / Fiumicino
SEB – Sebo Island, Netherlands Antilles
SFU – Sfux, Tunisia – Sfax Airport
SRE – Sucre, Bolivia
STX – St Croix Island, VI, USA
SUB – Surabaya, Indonesia – Juanda Airport
SUV – Suva, Fiji – Nausori
TAB – Tobago, Trinidad & Tobago & Taboão da Serra – Crown Point